########
###    #
#opx  ##
### xo##
#o##x ##
# # o ##
#x Xxxo#
#   o  #
########