######
#p   #
#  xo#
# ox #
######