#######
#p   ##
# xx  #
#  o o#
#     #
#######